0000000000000000000000000000000000000000000000000000000000000000
0000000000000000000000000000000000000000000000000000000000000000
0000000000000000000000000000000000000000000000000000000000000000
0004000000000000000000000000000000000000000000000000000000000000
0111111000000000000000000000000000000000000000000000000000000000
0222222000000000000000000000000000000000000000000000000000000000
0222222111111000000000000000000000000000000000000000000000000000
0222222222222000000000000000000000000000000000000000000000000000
0222222222222111111000000000000000000000000000000000000000000000
0222222222222222222000000000000000000000000000000000000000000000
0222222222222222222111111333331100000000000000000000000000000000
0222222222222222222222223333333200000000000000000000000000000000
0222222222222222222222222333332200000000000000000000000000000000
0222222222222222222222222233322200000000000000000000000000000000
0222222222222222222222222223322200000000000000000000000000000000
0000000000000000000000000000000000000000000000000000000000000000
0000000000000000000000000000000000000000000000000000000000000000
0000000000000000000000000000000000000000000000000000000000000000
0000000000000000000111111111000000000000000000000000000000000000
0000000000000000000000000000000000000000000000000000000000000000
0000000000000000000000000000000000000000000000000000000000000000
0000000000000000001000000000000000000000000000000000000000000000
0000000000000000000000000000000000000000000000000000000000000000
0000000000000000000000000000000000000000000000000000000000000000
0000000000000000000000000000000000000000000000000000000000000000
1111111111111111111111133333331111111111111111111111111111111111
2222222222222222222222333333333222222222222222222222222222222222
2222222222222222222233333333333222222222222222222222222222222222
2222222222222222222233333333333222222222222222222222222222222222
2222222222222222222223333333332222222222222222222222222222222222
2222222222222222222222333333322222222222222222222222222222222222
2222222222222222222222223335222222222222222222222222222222222222
2222222222222222222222225555222222222222222222222222222222222222
2222222222222222222222255555222222222222222222222222222222222222
2222222222222222222222555552222222222222222222222222222222222222
2222222222222222222225555552222222222222222222222222222222222222
2222222222222222222555555552222222222222222222222222222222222222
2222222222222222255555552222222222222222222222222222222222222222
2222222222222222255552222222222222222222222222222222222222222222
2222222222222225555552222222222222222222222222222222222222222222
2222222222222555555555222222222222222222222222222222222222222222
2222222222255555522555222222222222222222222222222222222222222222
2222222222255552222555522222222222222222222222222222222222222222
2222222222555552222555522222222222222222222222222222222222222222
2222222225555222222255552222222222222222222222222222222222222222
2222222225555222222255552222222222222222222222222222222222222222
2222222255555222222255552222222222222222222222222222222222222222
2222222255522222222225555552222222222222222222222222222222222222
2222222555522222222225555555555222222222222222222222222222222222
2222555555522222222225555555555222222222222222222222222222222222
2225555555222222222222255555555555222222222222222222222222222222
2225552222222222222222225525555555522222222222222222222222222222
2225552222222222222222222222222555525552222222222222222222222222
2255552222222222222222222222222225555552225222222222222222222222
2255522222222222222222222222222225555555555222222222222222222222
2255522222222222222222222222222225555555555555222222222222222222
2255222222222222222222222222222222255555555555522222222222222222
2222222222222222222222222222222222222222225555522222222222222222
2222222222222222222222222222222222222222225555522222222222222222
2222222222222222222222222222222222222222225555522222222255522222
2222222222222222222222222222222222222222222555555555555555552222
2222222222222222222222222222222222222222222555555555555555555522
2222222222222222222222222222222222222222222222555555555555555522
2222222222222222222222222222222222222222222222222222222222222222
