00000000000000000000000000000000
00000000000000000000000000000000
00000000000000000000000000000000
00040000000000000000000000000000
01111110000000000000000000000000
02222220000000000000000000000000
02222221111110000000000000000000
02222222222220000000000000000000
02222222222221111110000000000000
02222222222222222220000000000000
02222222222222222221111113333311
02222222222222222222222233333332
02222222222222222222222223333322
02222222222222222222222222233222
02222222222222222222222222222222
00000000000000000000000000000000
00000000000000000000000000000000
00000000000000000000000000000000
00000000000000000000000000000000
00000000000000000000000000000000
00000000000000000000000000000000
00000000000000000000000000000000
00000000000000000000000000000000
00000000000000000000000000000000
00000000000000000000000000000000
00000000000000000000000000000000
00000000000000000000000000000000
00000000000000000000000000000000
00000000000000000000000000000000
00000000000000000000000000000000
00000000000000000000000000000000
00000000000000000000000000000000
